1=
000000000000000000000
000000000000000000000
000000000000000000000
000BBBBBBBBBBBBBBB000
000BBBBBBBBBBBBBBB000
000BBBBBBBBBBBBBBB000
000BBBBBBBBBBBBBBB000
000BBBBBBBBBBBBBBB000
000BBBBBBBBBBBBBBB000
000BBBBBBBBBBBBBBB000
000BBBBBBB0BBBBBBB000
000BBBBBBBBBBBBBBB000
000BBBBBBBBBBBBBBB000
000BBBBBBBBBBBBBBB000
000BBBBBBBBBBBBBBB000
000BBBBBBBBBBBBBBB000
000BBBBBBBBBBBBBBB000
000BBBBBBBBBBBBBBB000
000000000000000000000
000000000000000000000
000000000000000000000#
2=
000000000000000000000
000000000000000000000
000000000000000000000
000BBBBBBBBBBBBBBB000
000BBBBBBBBBB0BBBB000
000BB0000BBBBBBBBB000
000BBBBBBBBBBBBBBB000
000BBBBBBBBBBB0BBB000
000BBBBBBBBBBBBBBB000
000BBBBBBBBBBBBBBB000
000BBBBBBB0BBBBBBB000
000BBBBBBBBBBBBBBB000
000BBBBBBBBBBBBBBB000
000BBBBBBBBBBBBBBB000
000BBBBBBBBBBB0BBB000
000BBBBBBBBBBBBBBB000
000B0B0B0B0BEBBBBB000
000BBBBBBBBBBBBBBB000
000000000000000000000
000000000000000000000
000000000000000000000#

